VjcHynFbKplDlIwXJAEq | DbEAwFXnJpHIljVqKcly
mu ejqofjklYvADwOmYmLAhy puzYwWtgjRZT | mzhq kYWjYO TytfeugDmmpZvwloYuLARjjwA
PefNaWnyb | yafNWePnb
BnQkKBOxo MeWGBlkCSze | QnBekSGBOMoKlxkzBW Ce
xrXueZxRPVZkHZirSfay FtzQaRp | xVPRuHekXpRZZrZzaa ytFfixrSQ
rBBPO pTjBQAtdcfq | dtfBBr PQOATBjcqp
HFzihbjTTtmEVtGlTIQIMAKCyyAk | VTCAKjyzMHTtQmGIbAFtIlhkTyiE
YtYedmG | eYdmtGY
fLsKtazPHh | PzaKHtfsLh
BISYkZ wSVazlsLZqvU DjnfwIkfklHQMDUkbvZ | fSIUBZvjabv kMZLDksVwwDYllzfZUnSQI kqHk
vyZGrUrFpfmggmQkrk  aaDJoe | gev agkr GmpyQrroUfZaJDkmF
gaTGCspNkVA | TaACsVpGgNk
ybJrmtVmTYDmTjsBmXPiP | yXDVsmtJBmjTPPTYbmimr
mZoTFrYDRPCGVggha | FGggRhramYVCDoTZP
FCyDZNxswwGsTNPujjYW | ZuyDwCYsNPFjTjxNsGWw
ctyoadEtPe | oEcePydatt
ugnTSPssfVA | SnuAVgsfPTs
IcaczhKaoxKJO | JachzOKKaoxIc
KszJYfdECVifBO | OBVifKCdJYsfzE
XUkJnSNmpbdZNfQEA | AbNNnkmXEJUfQdSZp
zEfgtcbBScdCmuYwwqVW | mzEuWcScdwbYBVwtqfgC
A tNsPsZXNIuhjYsvHlaDVylFIg | IvZy sNYgaHPDljVFsluhsAXNIt
JjUdFzyy | UyzdjyJF
vFVScanXVCYhDqIBmjT kECAK | SKnqFvCEjDATBVYX hICmkacV
hELLO cODEEVAL | Hello Codeeval
kXAMWbSt | bMStWkAX
AztRhQYreLQLVF Br TrCusE | srYrBFLQr  EVReuChzLAtTQ
OygKVw | VywKgO
ovbLivzJBuvmhGanxZqciRarj zWx TwLNQNYD | bTqivhGriLvvBYwoxxuRDNzjnJW LZa azmNQc
SAm zNVzvlkhgBXF | AFXhlzzNvkSmgBV 
tvNaqQl | NtaQqvl
RPOohZnNYEz | YZRzEONhPno
HaWVgDKYoqLKTR | oKDaHLVqgRTYWK
KWdImaqDgpYJPzeMoP | PgdDqoWmPKMJapYIez
fTErfQoljYJGueLXDz | GLDlYTzfjEQeXoJufr
vlMNdVYvJOveqNWrT | vlvevNONVTrWYMdJq
hOlCQvc swmKRzlf | lsO KhRcQlmfCvzw
JeapAgBoInlYCVNVbefUB | BlUIAenaebpBVJoVgYCfN
Hello Codeeval | Hello Codeeval
Heelo Codevval | Hello Codeeval
OJYsltVfltCySI | lfOCysIttSYVJl
xfeaWNnjxsYOtSpodLMXGFodTuRuGFsGR | GxTOjsaGdYsueSxFMfopFoLntRNWuXRGd
BrIKjUTRNYaxOacDWtBAJZwOsCw | RAxrjasNItOWOJaBCBKcYZUwTDw
LCMCoPcrkVkBFnpYBSDWVhUvH  |  nVhPHBcVkSBLDokCCYWrvUMFp
pmexxUwLNpsUBXRJGCBkvHpOSXFFTQyhKrWuRykl | UFQlsBLxRXxCkeuprwpJOhUkyGyKvTSFNBXpmWRH
oirMCyrKx | KMoiryxrC
WhDOi  |  iOhWD
Heelo Codevval | Hello Codeeval
jmbqwYhaBeqPqYn | mqBbjYPqqhnYwea
flGPVBNKECqaMS | CGPEafNlVqKMBS
xDWBM | MDWxB
gVDnYGiogeojDWctkWGOrb | jetGckronOgWYiWbDgDoGV
sxVpehkAeVmGkcmJUuhVUODuKOjd tockMsKXbi | dkjuscVeibksoVOtkhAucm mVhxKJOUMKepDUGX
k bsWATyOGIyOSKcJERslfDRKbHyRtNbVBTrgy | Acs TONGTrlORWKBREHDJsbybgVRybfykStIyK
SENHWx | ESNHWx
NzYcfyPzbnSipEwuHzKKJaaOgsVbdFRgoGI | sOcKVoYuibazPaKSbInFzggEzGwpyRfNJdH
YleLZphTIKxnvwdSVVqmhheGwohGu F | nvGmSZT eLeGuVhdwFoKxpYlqIVwhhh
OSOvX QzuqNJe | qzSOQuOvX JeN
mWApuumhm | ummumWhAp
SUWoyfgoMzYAFerTIHwVvNJemnu | VrYmWonvzoAMgUIFHwNeTSfyeuJ
WTKlShaGedkUgoYXYeo | WegGodTYeahlYUkXSKo
nCDxLYVTnZkhncfOzjiRAoeAL | OYCzcDLTeZnonhfnARxLjikAV
lJKjCISJpmDcldpgXRThn | SgmnjdTpKDJhcJIpRllCX
DsDRFJsNvZLq GQGSGmzzSjYdeDBciuuYWmmy | WGFBmSmQycijzL susDGZYSGmNquRdvDDJzeY
HdqkMjTaQJMOFBcdPaqrbXRpDbKNhS | jqrSKBPqkpROhcTQFDaXdbbMaMJNHd
IbnMNvRYjBnyHfRFqqEW | WYvREFInRbqnyNqBHfMj
Hello Codeeval | Hello Codeeval
QhLyXkbMoQqGy NQUTgxOhsufxszIV | ghTVsNUOQf kIMXobQyLQzGhyuxqsx
stIjcmCJqYQJOQTvUyslpFTGEa cPXt | sUqmFcQptPlTJJXQsaTjOCGvEtcyYI 
VduCvAjnpdJdCRNbpPedIHKoUdUVcA | dAIvRKpCVedPVUjpJuNUdAonddHCbc
NAmmlVoJNPGbichEfAJ UrXnzdxPgWyG | GximcJonJWANmzVEbXNhGrUAPP gdfly
QSTlvxJlfkc OyoRbcfsqjkTujWMoKWXEDmXusf | EfjXMSfOkcWmkuoRcsoyTjTQqDWl sblJXvKxuf
joFhPcWmPYM fkscktTgOpeMoizsJZbAHQDQOFty | PkQsAT stWcjpmzOcegPboOJthoDkFfZMMyYFiQH
hELLO cODEEVAL | Hello Codeeval
rFVrkAIeuGfwqLYYMevUaJrWse | JIYUeFerrAkLuvrqaseGYfWwVM
aSKkvPtMIxFVmeCJAahscQQmSqvrHZC | IPMVvhSmCxaecHFSCKQQmtAsqJarkvZ
 QoMVF | oMQV F
A jYSKN nTkKjBoioGnaHbPJuW |  SPjnYHWiKT uJoNbkjKBnAGao
fevYPYdUSLZtNtfhnTXxfJBX | xtXfNLTffZXvdPenBUYhStYJ
UjeHrWh | WUHejrh